LINK	リンク
link	リンク
list	リスト
leaving	リービング
navigation	ナビゲーション
content	コンテント
heading	ヘディング
main	メイン
Focus	フォーカス
Browse	ブラウズ
mode	モード
form	フォーム
image	イメージ
table	テーブル
header	ヘッダー
panel	パネル
push	プッシュ
button	ボタン
Screen	スクリーン
reader	リーダー
Wrapping	ラッピング
Finished	フィニッシュド
top	トップ
Loading	ローディング
loading	ローディング
wait	ウェイト
slider	スライダー
required	リクワイアード
invalid	インバリッド
landmark	ランドマーク
unvisited	アンビジテッド
visited	ビジテッド
banner	バナー
clickable	クリッカブル
tab	タブ
orca	オルカ
jtalk	ジェイトーク
